      Love: "Amor â¤ï¸"
      Family: "FamÃ­lia ğŸ‘¨â€ğŸ‘©â€ğŸ‘§â€ğŸ‘¦"
      Friends: "Amigos ğŸ‘«"
      Food: "Comida ğŸ”"
      Travel: "Viagem âœˆï¸"
      Photography: "Fotografia ğŸ“·"
      Music: "MÃºsica ğŸµ"
      Movies: "Filmes ğŸ¬"
      Books: "Livros ğŸ“š"
      Sports: "Esportes âš½"
      Fitness: "Fitness ğŸ’ª"
      Technology: "Tecnologia ğŸ’»"
      Fashion: "Moda ğŸ‘—"
      Art: "Arte ğŸ¨"
      Nature: "Natureza ğŸŒ³"
      Animals: "Animais ğŸ¶"
      Games: "Jogos ğŸ®"
      Party: "Festa ğŸ‰"
      Work: "Trabalho ğŸ’¼"
      Studies: "Estudos ğŸ“"
      Health: "SaÃºde ğŸ"
      Politics: "PolÃ­tica ğŸ—³ï¸"
      Science: "CiÃªncia ğŸ”¬"
      Space: "EspaÃ§o ğŸš€"
      History: "HistÃ³ria ğŸº"
      Culture: "Cultura ğŸŒ"
      Humor: "Humor ğŸ˜‚"
      Inspiration: "InspiraÃ§Ã£o ğŸ’¡"
      DIY: "FaÃ§a vocÃª mesmo ğŸ”¨"
      Beauty: "Beleza ğŸ’„"